1111111111111111111111111111111
1P0000C0000101000C0000000000011
1100100110000100000000000000011
1000111100000100000111111111111
1000001C00010000000000000000011
1000000100000100000111111111111
1111111111111111110100000000011
111111111100010C000111111111111
1C0000E000000000001111111111111
1111111111111111111111111111111