11111111111111111
10000C00C00000001
1P000011100000001
100000C0000010001
10000000000010001
10000001E10010001
100000C1110010001
100000000000000C1
10000011C10000001
1C000000010001001
10000C11000000001
11111111111111111