11111111111111111
10000000C000000C1
1P000011100010011
100100C0000010001
10010000000000001
10000001E10010001
100000C1110010111
100000000000001C1
10000011C10000001
1C000000010001001
10N00C1100000C001
11111111111111111