1111111111
10000E00C1
1P00011111
1000000001
1111111111