11111111111111
10C00011000C01
11110000001111
1N000000000001
1011001P100001
10000000000C01
11110C00110001
1E110000000111
10111100010001
100000000000C1
11111111111111