11111111111111111111
10P00C0000000000C011
10000001110001000001
1000000000C001000001
11111100000001000001
111111000000010C0001
1C000000010001000011
1000000001000C0000C1
10000110010000000011
100001100C0000000001
1N000000000000000001
1C001100010000000101
1111110C0110000011E1
11111111111111111111